    ###
#####.#
#   @ #
#%#%#%#
#&#$# #
# % & #
#######
