      ###################### 
   ###    &     %%%%%      .#
  #             #  ##    @  #
 #   &######    #  ## #######
 #      #%%     %           #
 #%%%##%#%%######%%%####%%###
 #   #  #   ###      ###    #
 #   #  #     %   &  ###  ###
#  & # &% $   %      &      #
 #      #################### 
  ######                     
